111111111111111111111111111111
10010000000C000000000C00000101
100001111100000000000000000001
100000E000000000000000P0000001
100000000000010000000000000001
100010000C0000000C000000000001
10000C000000000000000001000001
10000000000CC00001000000000C11
111111111111111111111111111111
