1111111111111
1111000000001
1110111111011
1100111C00E11
1000000C000P1
1111111111111
