1111111111111
1001000000001
1000111111011
1100111C00E11
1000000C000P1
1111111111111
