1111111111111111111
1P010C0100010C00001
10010001010C0000011
1C00101C01000C01001
100C00C0000C0000E01
1111111111111111111
